1111111111
1000000011
10000P0001
1X000000E1
10C0000001
1111111111   