1111111111
1000000001
10000P0001
10000000E1
10C0000001
1111111111