11111111111111111111
10000000101000000001
1000C000101000000001
100P00001110000000E1
100000000000C0000001
10000000000000000001
100X0000000000C00001
10000000111000000001
1000C000101000000001
1000000010100C000001
11111111111111111111